11111111011111111
10010001010001001
11111111111111111
10010001010001001
11110111011101111
00010000000001000
00010000000001000
00010000000001000
00010000000001000
11110111011101111
10010001010001001
11111111111111111
10010001010001001
11111111011111111